






#####$##########################
###########$#####$##############
###$#######$#######$#######$####
######$##############$##########
###############$################

