






#####$#################$
$################$######
###$###$###$####$##$####
######$##############$##
###$###########$########

